BBBBBBBBBBBBBBBBBBBBBBBBBBBBBBBBBBBBBBBBBBBBBBBB
B                                              B
B                                              B
B                                              B
B                                              B
B                                              B
B                                              B
B                                              B
B                    P        BOOOOB           B
BBBBBBBBBBBBBBBBBBBBBBBBBBBBBBBBBBBBBBBBBBBBBBBB
